#########################################
#.....#.........#.......#.....#.......#.#
#.###.#.###.###.#.#.#####.#.###.#.###.#.#
#.#...#...#.#.....#.#.....#.....#...#.#.#
#.#.#.###.#.#.#####.#.#############.#.#.#
#O#.#.#...#.#.#...#.#.#.....#...#...#.#.#
###.#.#.###.###.#.###.#####.#.#.#.###.#.#
#...#.#...#.....#...#.....#...#.#...#...#
#.#######.#########.#####.#####.###.###.#
#.#.........#.....#...#.#.#.....#...#...#
#.#.#########.###.#.#.#.#.#.#.###.###.###
#.......#...#...#...#...#.#.#.#...#.....#
#########.#.#.#.#########.#.#.#.#########
#...#.....#.#.#...........#.#.#.........#
#.#.#.#####.#############.#.#.#########.#
#.#...#.#...#...........#.#.#.........#.#
#.#####.#.###.#########.#.#.#.#########.#
#.#...#...#.....#.#.....#...#.#.........#
#.#.#.#.#######.#.#.#########.#.###.#####
#...#.#.......#.#.#.........#.#.#...#...#
#.###.#######.#.#.#.#######.###.#####.#.#
#...#.#.......#.#...#S#...#...#.#.....#.#
#.###.#######.#.#.###.#.#####.#.#.#####.#
#.#...#.....#...#...#.#.........#.#...#.#
###.###.###.#######.#.###########.#.###.#
#...#...#.#.......#.#.........#...#...#.#
#.#.#.###.#######.###########.#.###.#.#.#
#.#.#.#.......#.#.#.......#.#...#...#.#.#
#.###.#####.#.#.#.#.###.#.#.#####.###.#.#
#.....#.....#.#.#...#...#...#.......#.#.#
#.#####.#####.#.#####.#######.#######.#.#
#.#...#.....#.#.....#.........#...#...#.#
#.#.#.#.###.#.#####.#############.#.###.#
#...#.#.#...#...#.....#...........#.....#
#####.#.#.#####.#.###.#########.#.#######
#.#...#.#...#.#...#.#.......#...#.....#.#
#.#.#######.#.#####.#######.#.#######.#.#
#.#.....#...#.#.....#.......#...#...#.#.#
#.#####.#.###.#.#.###.#########.#.###.#.#
#.........#.....#...............#.......#
#########################################
